Replaces the music of vanilla and Fargo's Souls bosses, events and biomes. 
Can be used without Fargo's Souls for only the vanilla tracks.

Thank you Javyz!

Songs included:
Town (Day): Blue Archive ~ OST 214
Town (Night): Blue Archive ~ OST 198
Overworld (Day): He Is Just Very Lucky ~ Trance Music For Racing Game
Overworld (Day, alt): Blue Archive ~ Mischievous Step
Overworld (Night): Persona 5 ~ Beneath the Mask
Windy Day: Actual Literal Clown Music
Underground: Kirby's Return to Dream Land ~ Slippery Steps
Desert: Kirby 64 ~ Rock Star
Snow / Ice: Kirby Air Ride ~ Frozen Hillside
Jungle: Matt MVS ~ New Zelda Forest Temple Music (IT'S BRIN)
Jungle (alt): Super Metroid ~ Brinstar
The Hallow: Rabi-Ribi ~ Sky High Bridge
Underground Hallow: Rabi-Ribi ~ Warp Destination
Corruption: Super Paper Mario ~ World of Nothing
Underground Corruption: Super Paper Mario ~ River Twygz Bed
Crimson: Metroid Zero Mission ~ Tourian (Arranged by Kassil)
Underground Crimson: Super Metroid ~ Tourian
Ocean (Day): Plants vs Zombies ~ Watery Graves
Ocean (Night): Metroid Fusion ~ Lower Sector 4 (Arranged by Kassil)
Space: Sakuzyo ~ ShadyShady
Hell: DOOM Eternal ~ The Only Thing They Fear Is You
Mushroom Biome: Blue Archive ~ After School Dessert
Dungeon: Super Paper Mario ~ Castle Bleck
Temple: Castlevania Symphony of the Night ~ Wandering Ghosts
Rain: Rabi-Ribi ~ Unfamiliar Place
Thunderstorm: Blue Archive ~ OST 202
Graveyard: Blue Archive ~ Gestalt Angst
Eerie: Blue Archive ~ Step of Terror
Sandstorm: Blue Archive ~ Endless Carnival
Aether: NieR ~ Song of the Ancients (Duet)
Goblin Invasion: Zenless Zone Zero ~ Camellia Golden Week (Combat)
Slime Rain: Blue Archive ~ Unwelcome School
Pirate Invasion: Blue Archive ~ DAN! DAN!! INVADER!!!
Eclipse: Raisi K. ~ The Battle (Theme of Thunderblunder777)
Pumpkin Moon: HoloCure ~ Koyoi Wa Halloween Night!
Frost Moon: Paper Mario The Thousand Year Door ~ Combat (Chapter 7)
Old One’s Army: Blue Archive ~ Operation DOTABATA
Martian Madness: Rabi-Ribi ~ System Interior

Trojan Squirrel: HoloCure ~ Suspect
King Slime: Sakuzyo ~ rePrologue
Eye of Cthulhu: Paper Mario The Thousand Year Door ~ X-Naut Fortress
Cursed Coffin: Super Mario 64 ~ Shifting Sand Land
Eater of Worlds: DM Dokuro ~ Last Battle (Ballos Mix)
Brain of Cthulhu: Super Metroid ~ Mother Brain
Queen Bee: Regnum Caelorum Et Gehenna ~ Verum Cur Non Audimus
Skeletron: George Thorogood & The Destroyers ~ Bad to the Bone
Deerclops: Jujutsu Kaisen ~ No Hesitation (Abridged)
Devi: Blue Archive ~ Usagi Flap
Wall of Flesh: Demetori ~ Necrofantasia
Dreadnautilus: Blue Archive ~ Blood Stained Faith
Queen Slime: Dedede's Drum Dash Deluxe ~ C-R-O-W-N-E-D
Banished Baron: BREIS ~ X Vs Zero Decisive Battle 2
Skeletron Prime: Blue Archive ~ PACHAD
The Twins: Sound Ave ~ Storm Rider
The Destroyer: Diverse System ~ Nightmare Paradise (Abridged)
Lifelight: SEQUEL colony ~ Kizuato
Plantera: Magia Record ~ Gekkasakuya
Golem: UNDERTALE ~ MEGALOVANIA
Betsy: Better Call Saul ~ Intro
Duke Fishron: Megaman Zero ~ Cannon Ball (Mythos)
Empress of Light: Touhou Perfect Cherry Blossom ~ Border of Life / Resurrection Butterfly
Lunatic Cultist: Blue Archive ~ OST 232 (Chokmah)
Celestial Pillars: Blue Archive ~ Our Oath
Moon Lord: Blue Archive ~ FURY OF SET

Timber Champion: HoloCure ~ Stardust Song
Terra Champion: Castlevania Aria of Sorrow ~ Last Battle
Nature Champion: Masahiro Aoki ~ Frostbite
Life Champion: BlazBlue ~ conciliation
Shadow Champion: Metroid Samus Returns ~ Proteus Ridley 3
Earth Champion: Zenless Zone Zero ~ Pompey
Spirit Champion: The Binding of Isaac ~ Sketches of Pain
Will Champion: Mamoru-kun Wa Norowarete Shimatta! ~ Will Force
Eridanus: Rabi-Ribi ~ Sudden Death
Abomination: Project Wingman ~ Showdown
Mutant: Kirby's Return to Dream Land Deluxe ~ Supreme Ruler's Coronation - OVERLORD
Mutant (alt): Zenless Zone Zero ~ Battle Trials (Glory)